10 10 
-.-.-.-.-.-.S.W.S.S
-.G.-.S.-.-.B.S.S.W
-.-.S.W.S.B.P.B.-.S
B.-.-.S.-.-.B.-.-.B
P.B.-.-.G.-.G.-.B.P
B.-.-.B.-.-.-.-.-.B
-.-.B.P.B.-.-.B.-.-
S.-.-.B.-.S.B.P.B.-
W.S.G.-.S.W.-.B.-.G
S.-.-.-.-.S.-.-.-.-