10 10
-.-.-.B.-.-.-.-.-.-
-.-.BG.P.B.-.-.-.-.-
-.-.-.B.-.-.-.SG.-.-
-.-.-.-.-.-.S.W.S.-
G.-.-.-.B.-.-.S.-.-
-.-.-.B.P.B.-.-.-.-
-.G.-.-.B.-.-.-.-.G
-.-.-.-.-.-.-.S.-.-
-.-.B.-.-.-.S.W.S.-
-.B.P.B.-.-.-.S.-.G