10
-.-.-.-.G.-.S.W.S.G
-.G.-.S.-.-.B.S.-.-
-.-.S.W.S.B.P.B.-.S
B.-.-.S.-.-.B.-.-.B
P.B.-.B.G.-.G.-.B.P
B.-.B.P.B.-.-.-.-.B
-.-.-.B.-.-.-.G.-.-
S.-.-.-.-.S.-.-.-.-
W.S.G.-.S.W.S.-.-.G
S.-.-.-.G.S.-.G.-.-